#########
#OOOOOOO#
#OOOOOOO#
#OOOOOOO#
#OOOOOOO#
#OOOOOOO#
#OOOOOOO#
#OOOOOOO#
####O####