#########
#OOOOOOO#
#OOOOOOO#
#OOOOOOO#
OOOOOOOOO
#OOOOOOO#
#OOOOOOO#
#OOOOOOO#
#########