####OO####
#OOOOOOOO#
#OOOOOOOO#
#OOOOOOOO#
OOOOOOOOOO
OOOOOOOOOO
#OOOOOOOO#
#OOOOOOOO#
#OOOOOOOO#
####OO####