####O####
#OOOOOOO#
#OOOWOOO#
#OOWWWOO#
OOWWWWWOO
#OOWWWOO#
#OOOWOOO#
#OOOOOOO#
####O####