####OO####
#OOOOOOOO#
#OOOWWOOO#
#OOWWWWOO#
OOWWWWWWOO
OOWWWWWWOO
#OOWWWWOO#
#OOOWWOOO#
#OOOOOOOO#
####OO####