###############
#OOOOOOOOOOOOO#
OOOO#######OOOO
#OOOOOOOOOOOOO#
###############