#########
#OO###OO#
#OOOOOOO#
OO#OOO#OO
#OOOOOOO#
#O#OOO#O#
#OOOOOOO#
#O#OOO#O#
#OOOOOOO#
#O#OOO#O#
#OOOOOOO#
##OOOOO##
###OOO###
####O####
